00000000000
01101110010
01000100110
01110110010
01010000110
01010100010
01000111110
01111100000
00000000000
00000000000
00000000000