00002000000
00000000000
00100000000
00000000222
00100000000
00000000000
00100000000
00000001000
03300011000
00000000000
00000000000
000003