########
#    OO#
#    XX#
# P #  #
# X    #
#   #  #
#  ### #
## #   #
##O#   #
########
